16 16
EEEEEEEEEEEEEEEE
EEEEEEEEEEEEEEEE
EEEEEEEEEEEEEEEE
EEEEEEEEEEEEEEEE
EEEEEEEEEEEEEEEE
EEEEEEEEEEEEEEEE
EEEEEEEEWEEEEEEE
EEEEEEWWTWWEEEEE
EEEEEEWWTWWEEEEE
EEEEEEEWTWEEEEEE
EEEEEEEETEEEEEEE
EEEEEEEEEEEEEEEE
EEEEEEEEEEEEEEEE
EEEEEEEEEEEEEEEE
EEEEEEEEEEEEEEEE
EEEEEEEEEEEEEEEE