8 8
WWWWWWWW
EEETTEEE
EEETTEEE
EEETTEEE
EEETTEEE
EEEEEEEE
EEEEEEEE
EEEEEEEE