8 8
EEEETTTE
EEEETEWW
EEEETEWW
EEEETEEE
EEWWWEEE
EWWWWEEE
EWWWEEEE
EEEEEEEE