8 8
WWWWWWWW
EEETTEEE
EEETTEEE
EETEETEE
WEEEEEEW
EEEEEEEE
EEEEEEEE
EEEEEEEE