8 8
WWWWWWWW
WEETTEEE
WEETTEEE
WETEETEE
WEEEEEEW
EEEEEEEE
EEEEEEEE
EEEEEEEE